128,128
@@@@@@@@@@@@@@@@@@@@@@@@@@@@@@@@@@@@@@@@@@@@@@@@@@@@@@@@@@@@@@@@@@@@@@@@@@@@@@@@@@@@@@@@@@@@@@@@@@@@@@@@@@@@@@@@@@@@@@@@@@@@@@@@
@I.....H.........H......H.......H.......H...HAH...........A...H..HA...........H..........H@.A.A......A..............HH..AA.HAA..
@..H..A......AA.....H.AA.A.H.......HH.H..A.....A..A...H.A.......................A.H....AAH@A...A..AH....H......A......A.........
@.AH..AHAH.HH......A..A..H........H...H.HA..H......H.A.H.A............H..A.....H....A....H@A.........H......H..................A
@H..A...A.......H...HA.H...........A......A..A.......H.H.............H......HA.....H..H.H.@..HH..H....A.H...H...H.H.A..........A
@.A..A...H..............A........A........A.H....A...AA.....A......AH....H..........H.....@..HAHA........A.A..HA..............A.
@..H..A...A.H.......H....................HH..H...........A....AA...A.....A...A.H..A.H..A.A@H....H..HH...A.........A.....H.....A.
@..H.A........H.A......A.A..HA.......H....H.H..HA.............H.H......A.........H..A.....@....H..H...A...A............AHAH..A..
@A...H..@....HA.@.......@@@@@@@@@@@@@@@@@@@@@@@@@@@@@@@@@@@@@@@@@@@@@@@@@@@.......@.AA.A..@....H...@.AA...H@A.H....@@@@@@@@@@@@@
@.......@..A..A.@..H.....A.....A.......A.@.....HHH.A.....................A@.H.H..H@.A..A.H@.H.....H@..A....@.H.H.......A....A..H
@.....AH@.H.H...@.H.H......HHH.A.H....H..@.H...A.......H.H.H......H.....H.@....A..@A.....H@........@A...H..@....AA...A.A....HA..
@......H@...HA..@.........AA.....A.......@........H....H..HHHA...HA.....H.@.......@H......@......AA@...A...@.....A...H......H...
@H...H..@HA.....@..H......H....H.........@.A........A......AH...A....A....@..A....@..AH...@..H...A.@......A@........HA..A..A....
@A..H...@.HA.A..@...........H......H.....@..H...A....HA...A.AH.......H..H.@......H@.H....A@......H.@..H.A..@H...HA..............
@..H....@...HA..@......A..........H......@........H.......HA....H...H.H.AH@HAH....@.......@.H.A....@.A..A..@..........A..A.H..H.
@..HA...@A....A.@...H...........A.....A..@..H..AH......HH..A.....AH.......@.......@.......@.HAA.H..@H....H.@..H.A..A...HA..A....
@.....H.@@@@@@@@@@@@@@@@@........@@@@@@@@@.......@@@@@@@@@@@@@@@@@@....A.A@...A.A.@@@@@@@@@...H.H..@......H@@@@@@@@@@@@@@@@@....
@.HA..H.......H.@.A.H...@H......A@.....H........H@A..A........H...@.........H.HH..@..............A.@....H........H......H..@....
@....H.H..H.....@.......@..A.....@.....HHA..AA.HH@HH..A....A..AA..@......HHA......@.A..AA.....AA...@....H........A...A.....@A...
@A..............@A.H....@........@H....H......A..@...H........H.A.@..H.AA.AH....A.@.A..............@......AA.H..AA....HA...@....
@.H.............@.......@.H.A....@...H......H....@...AHH...A......@..........A....@...AA....A......@..........H.A....H.HH..@A..H
@..AH...H......A@H...A..@AH......@....A.HHH...H..@.H..HH....H.....@.......H.H.....@.......A.....A..@AH..........H..H.......@H..H
@A.A..........A.@.H.A...@H.H..AH.@H........H....H@..HA............@H...H..........@..A.......H.H...@......A..A......A.....A@....
@........A....H.@A.H...A@H....A..@.A....H........@.AA.....H.......@.A..HH.......H.@...A...AA.......@......H....A......H.A..@....
@...A...@@@@@@@@@....A..@@@@@@@@@@.HH.H..@@@@@@@@@...H...@.A.H....@@@@@@@@@...H.A.@.H.HH..@@@@@@@@@@@@@@@@@@@@@@@@@@.H.....@@@@@
@.......@........H...H..@..H...H..H......@..HA.A...A....H@........AH...........A..@H......@........H.......A......H@.........H..
@......A@HHH.........A..@.......H......HA@......HAA......@.........H....A....H....@....A.A@......H........A..H.....@A....H..A.HA
@.......@.A.....AA....HA@.AA....H..H.....@H.A........HA..@........................@HA.A..H@....HA.A....HH.A.H......@....A.H.....
@A......@......A.....A.H@..A.....HH.A..A.@.......H.......@......HA........A.AHA...@H......@.A....H....A....HA....A.@.H...H.H....
@A.A....@A..H..HH......A@A...A.....A.....@HHA...H......A.@................A...H...@.......@..A...HH....A..H...A....@...H.A.....A
@...H..H@...H.....A..A..@......HH.......A@..........A....@HAAA...H......H..H.....A@.H.....@......A........AH....H..@....A...H...
@...HA..@.H...........A.@.HA.....HA.H....@AHA..A........H@...H...HA...A....HA.....@.....A.@.H.........A............@.....H..A...
@.H..H..@H.AHH........H.@...........AA.H.@....A........A.@..HHA.A......H..........@.......@..A....A.HAAH...H...A...@.......A..A.
@..H....@A......@@@@@@@@@..HH..A.@@@@@@@@@.A...HA@@@@@@@@@@@@@@@@@@@@@@@@@@@@@@@@@@.....A.@.......H@....HH.@@@@@@@@@@@@@@@@@....
@H...A......AH..@H...H........A..@..H..........A.A.HH.......H.......H...H........A@...A.......HA..A@...A.....A....A@.......AH...
@H...A.HH.......@........H.......@.A..............H.....H........HA.H.........A.H.@...............A@...H..AH...AA.H@....A.......
@..A....A...H...@..A...A.H...A...@...........H...H..........H...H......H....H.....@AH............A.@A........A..HH.@..A..A.A....
@..H.....HH.H...@...........H...H@..A.....HH...H.H............A..A..........HHHH..@............H...@...A..HHH..A...@.HH......H.A
@.H.H.HHH.......@.....H......A...@....A........A........A........A.H...H..A.H.HA.H@H..H...AHH....HH@.A..H.H...H....@.A.....H....
@............AA.@..AH.H...A....H.@.........HH..H...AA.............H...H..HH.......@........H.......@........A.A....@...HA..A....
@........H......@A....HH.........@H...............H..A......HH......HH.HH.....HAHA@.....AH.H.....AH@.......A.....A.@.AH.A......A
@.......@@@@@@@@@H......@@@@@@@@@@@@@@@@@@@@@@@@@@@@@@@@@@@@@@@@@@@@@@@@@@@@@@@@@@@..H.H.A@@@@@@@@@@@@@@@@@@@@@@@@@@......H@@@@@
@.....A.@A...H..A.......@A..H..A..............HH...A..H......H...A@.......A.......@.......@..H....A@H.......H...H.H@....A.....H.
@.......@..A..........A.@..H.....H......H.A.......H.A.A......H.A.A@........A......@.H....A@...AH.HA@.........AH....@..A.........
@..A...A@.......AA.A..H.@.........................................@AHAH........HH.@.......@..A.A...@..............H@....A.......
@.......@H...A..H.....AA@....A.....A..AH..HA............A.A.H...A.@..............H@A..AAA.@H..AAH..@A....A..H..A...@..........HA
@......H@A........A....H@.H.HA...H.AH........H..A....H...H..H..AH.@.A..........H..@.......@....H..H@...A.....H.A...@...H.A......
@A......@A..............@.....AA.HA.H....H.......A.......A...H....@H..A......H....@H.....H@..H.....@..H...HHH...AA.@....H.....H.
@..A..AA@.......A....A..@.H.H........A.A..H.........A.H...A..AH...@..A........HA..@..H....@.HA...A.@....AH..AH....H@...H...A....
@@@@@@@@@.......@@@@@@@@@..H.H...@@@@@@@@@@@@@@@@@@@@@@@@@........@A.....A@..H....@.....A.@..AH....@.H.H...@.A.....@@@@@@@@@..A.
@.A.A.H.H.H.H.........A.@H.H...A.@.......@...H..H..........H...A..@....H..@A......@...........H....@HH.....@......AH.A.....A..H.
@HHH..A.........A.....AA@...HHHH.@H......@H.......H...HA...H..H...@.....A.@.......@....HH......H...@.......@A.A.........A.....AH
@.....A......HHH..A.....@..AA....@..A....@......A............A....@.......@.H..H..@....A...........@.......@..AA..............H.
@.........AH....A.AA.A..@A..HA...@.......@.....H....H..A.....HH.A.@A.H...H@.......@.H.H.H..........@......H@...........H...AAH..
@A..HA..H....HH...H...A.@......A.@......A@....A.A......A.AA.......@....H.H@.....H.@.....H.......A..@.A....H@..H..A......H.......
@..H..A..........H.....A@H.......@..HA.A.@................AH......@...HH..@....A..@...H..A.........@H......@.H.H..H.A...........
@AA....A.H.............H@...A...A@..H....@H.A.....HHA.A...........@..A....@...A...@.......H.A....A.@H......@.A..............AA..
@.......@@@@@@@@@@@@@@@@@@@@@@@@@@A...A.H@@@@@@@@@.H..H..@@@@@@@@@@.......@.......@.H....H@@@@@@@@@@....H..@@@@@@@@@@@@@@@@@@@@@
@...AAH.........A......H.............H.A.......H.@A......@..HA.......H....@.A...A.@..A.A...A...H...@....HHH..H............A.....
@..H..........AH................H...........A....@.A....H@................@H......@HA...AA.A.......@...A......A....H....A......H
@.A......A............HA.H...A...H........H......@..A..A.@..H.A......AA...@.......@.H.H...A..A.HH..@.H.......A...A.AA.........A.
@..AA..H............A.HHH..........A.............@A...AAH@..............AH@.....A.@.A...........HHH@.....................AA....A
@....HA....A.....AA.A.H.A......A.....A...A.......@.....H.@...A...........A@H...A.A@H.......A.......@.H.AAA......H....H.....H....
@..A.H.........A............HHAA.AH...H....H.....@AH.AA.A@.AH.....A.A.....@...AH..@.AH...H.........@.HH..H....AA..............HA
@..HA.AH..A..H..H...H............AH.....A.......A@.H...A.@.A............AA@.....H.@HA....H....A....@.....H..A....A.HA...A...H...
@.............H.H..........AAH....AH...AA......A.@..A..H.@................@......H@......A........H@...AA.......H....H..H.H....H
@..A....@@@@@@@@@@@@@@@@@..H.A...@@@@@@@@@@@@@@@@@.A..A.A@@@@@@@@@@@@@@@@@@.AH.H..@...A...@........@.AHH...@...AA..@@@@@@@@@...A
@...........A...@..H.A..@H..HH...............A...@.......@..H..H......H..A.HA.....@.......@.....AA.@.A....H@...A..H@........HH.A
@............H..@.....A.@..H...H........A...H....@.......@A..................A....@.......@..A.H...@....H..@....A.H@.....H......
@.....AHAH......@....AA.@A....A.......H....HH....@..H....@H.......A..AA.HAH.......@..H....@...A....@..H.A.H@.......@.......H...A
@H.............A@H.H.H..@.....A..............A...@...H.A.@....A..........A....H...@.......@.H......@....A..@..A....@....HA.....A
@..H.........H.A@.A.A...@H......A............H...@.A.H...@........H.H............H@.....AH@A....H..@.......@H.A....@H...A....HA.
@...A...H....H..@.......@..A.A..A..H..........H..@.HA...H@.............A..H......A@A....H.@...H....@..H....@..A....@..AH......A.
@...H...........@.......@..A.A..HA...............@A....A.@.....A..............A...@.......@....H...@.HA....@.....H.@.........H..
@.A.....@....H..@H.A....@@@@@@@@@@.......@..A.H..@.......@@@@@@@@@@@@@@@@@@..AA.A.@@@@@@@@@@@@@@@@@@@@@@@@@@@@@@@@@@.......@@@@@
@.....H.@...A.......H...@..........H.....@....H.H.....AA..............H.H.AAH....A@.....H..A........AA..H.H......AA@...........H
@.......@H..HA.......A.H@.........AA....A@..A..........AA...........H...........H.@................H.....A.....H...@...HA....A..
@....A.A@.....H.........@H.AA..........HA@...A.AA.A........H...HHHH.......A..AH...@.....HA......H....H.............@.......H....
@AHH...A@...HH..A....H..@AH.A...AH...H..H@H.H.AH.H...H...............A.......AH...@.......HHA...AH...........HA.A..@..AH........
@..H.H..@A..H...........@.A.A.......H....@..A....H...H....AH........HHA........A..@.A.....H.......A....A....A......@A.A........A
@..A....@.H......H.H.A..@..A...A.....H...@A.......A............AH.H.H....A......H.@......A......A.H...A.....H......@...A........
@...H...@..H.H...H.....H@...A.HAH..H..AA.@A.....A.H.H...A.....H...................@....A...........H.H.............@.......A..AH
@@@@@@@@@@@@@@@@@.H.....@@@@@@@@@@.......@@@@@@@@@@@@@@@@@@@@@@@@@@@@@@@@@@@@@@@@@@.......@...A....@@@@@@@@@AA.....@......H@...H
@....H..A.......@.......@.H...A.A@......H......A.@A..H........H....A..HA..H.......@..A.A..@.....A..@....H..........A......H@..A.
@.A........H.HH.@....A..@.......A@..........H....@......................H....HHA..@.......@........@..H.A..A.A.H.......A...@....
@.......H..H.H..@.....H.@.HA.....@.A............A@.A......H......H.......A........@.A..A.A@.A......@...A................H..@HA..
@.....H.........@.......@.......A@..A......AA....@.................HA.......AHA...@.H.A...@A....A.A@A...H.................A@...H
@...A.HH.HH.....@....H..@A..H....@..AAH.........A@A.......AH........H.....A..H....@.AA....@...H....@...H..A.............AA.@.H..
@....A.....HA...@.....AH@........@........H......@.A.....AHH........A.H.A..H......@.....H.@........@......A................@...H
@..H..HAHHH.....@H....HH@...A..A.@HHA..H.AAA.....@A...A....H....HA....H....H....H.@.H.....@H.......@....A..................@....
@@@@@@@@@.....HA@.A.....@...A....@HA.....@.A.....@@@@@@@@@A.......@..H...H@@@@@@@@@...A...@H...H...@@@@@@@@@@@@@@@@@@@@@@@@@@@@@
@...............@AH......A...AA..@AA.....@.H..H...H....A.@.A.H.A..@..............H...A....@H.....A......HAA..H.....H........H...
@...H...A.AHH..A@..A.H..A........@.H.....@.H.........HH..@......H.@.A.....A...A.A.........@........A..A....A.H...A.A.........A..
@...H.....H....H@.H........A.A.HH@.......@H....HA.....HA.@........@.....A...A.....A.A.H..H@.A.........H.....AAA............A....
@H..H....A.....A@......H.......AA@......A@...H....A......@A....H..@..A..H....A...H.H.....H@.H.HA........A......AH...............
@......A........@...H..H....A.A..@.A....A@.....AH..A....A@........@.........H............H@..A..H..AH......A....H.............H.
@....HH......H.H@..A..A.......A..@.......@HA..AHH.H...A..@......H.@.....A..HAH.A.HAA..HA..@..HH............H..........HA........
@...........A...@H............H..@A...H..@...H.........H.@...A....@....A....HA.A......H.HA@A.......A....A.AA..A......A....H.HH..
@....A..A...H..H@..A...H.......HA@.......@..........A....@...A....@.......A.......A.......@.H.....A........A.............A......
@..H....@@@@@@@@@@@@@@@@@...H....@@@@@@@@@@@@@@@@@.......@.H.H...A@@@@@@@@@..H....@@@@@@@@@........@@@@@@@@@@@@@@@@@@@@@@@@@....
@.........H........A....@......A..A.....H@.H.............@........@...AA..@.......H...H...@......A.................@............
@......A.............HH.@..A...A.....A...@...............@.....HH.@.......@....H........H.@..................H.HA.A@...H..AH..H.
@.......H..A.A.........A@..A.............@....H..A...AA..@A...A...@H..A...@.....A.A.......@..A...A.......A.H.AAA.A.@............
@.....H....H......AH....@.......AAA....H.@A.........HH..H@...H.A..@.......@H.HA.A........A@.A...........A........A.@H.A..H......
@.................A.H.A.@.......H.....H..@.......A.....H.@.......A@......H@........HHA....@H.........AA......H.....@.A.A.......H
@.......HH....A.........@............A...@...............@........@.......@...A..........H@..........H...H.........@H...........
@A.H......A.......AA....@............A...@...........H...@........@...A...@.H.......HA..A.@.A..A...............A.H.@......A..H..
@.....A.@@@@@@@@@@@@@@@@@H..H..A.@@@@@@@@@...A..H@@@@@@@@@H......A@....HA.@@@@@@@@@.....H.@@@@@@@@@@@@@@@@@@@@@@@@@@H.HA...@....
@.......@...H......AA...H..H.....@....H...A......@....A...H...AH...H....H.AH...H.A@...A.H.AHA...A..@..........A.....H.A....@HH..
@......A@...........H............@.A.....H.......@..........AHH.H...........A.A..A@...A.A...H.....H@.H.........A.....H.....@A...
@AAA.A..@.HA.A.............HH.A.A@.........HH....@.................A..A.......A...@A....A..........@.....H....H..HA.H...A.H@....
@.......@......A....H..A..A......@...HHA.........@...................A............@.H............HA@..A.A..........A......H@A...
@......H@..........HH.H.AH.A...H.@......H..A.....@.A.....A...H...........H.H.A....@.............A..@.HA............H.......@...H
@.....AH@.A...........A...A.....H@H........A.H...@...HAA...HA.AH..............A...@...H..H..A......@..A......H...H......H.A@..H.
@.A.....@A..........A.A..........@....A.HH.H.....@........A.....H.H......A...H....@H.......H..H.HA.@A........H.A...........@...H
@.......@.......@@@@@@@@@@@@@@@@@@@@@@@@@@..A...A@@@@@@@@@@@@@@@@@@@@@@@@@@H.H.A.H@@@@@@@@@@@@@@@@@@A.....A@@@@@@@@@@@@@@@@@HA..
@.A..........A..@....A.....H.............@...H...@.........H......@HH.HHA.HA.A..HA@................@..A....A.....AH@...........A
@.H.A...H...H...@.AA..............A...HA.@.....A.@...HA..........H@HA..AH.......H.@....H..H........@A..H.A.....H..A@...AA.......
@....AH.........@A........A...H..HH....H.@.......@......H...A.....@A...H..........@........A.......@H...H...AH.A.A.@.....H..H...
@.......H.......@..H.......H..A..........@.A.....@AA.....H......A.@HAH...AA.....AA@...H....H.......@.A.......A.A.HH@.H....H.....
@...............@...HH..H.....A...HAA.A.A@.H.....@.........H..H.A.@......HA...A...@A..A..........H.@.H.....H..H..AA@..HA..A..H..
@....H..........@..A.H...A...H...........@...H...@A...........A...@.....HA..AH....@.H.....A...H....@........H......@.....A..H...
@......A..AA....@..A.A..............A..HA@.......@.....HAH.......A@..A...H........@.HAA.....H.H....@..H.......H.A.H@..H.........
@@@@@@@@@..H....@@@@@@@@@..HH..H.@@@@@@@@@.....H.@.......@H..A....@@@@@@@@@@@@@@@@@.......@........@@@@@@@@@....A..@@@@@@@@@...H
@AA.H.A..HA......A..H.H..........@A..H........A..........@AH........A........HA.AAA.AA....@...A...A....A..A.A.....A.H..H..A@..AH
@...A...H.....A..........H..A.H..@.............H.....A...@H.........A..A..A...HH..H.H.....@.A....A.......A.H..H....H.....A.@...A
@A...H.A...A.....H...H....A....H.@..A............A.......@..............................H.@..H.....H.....A....A............@....
@H.A...A..H.H...........HH.AA.H..@...A....AA...AH.H.A....@..AHA...H..A.................H..@....A..H.......A...H.H..........@.A.G