128,128
@@@@@@@@@@@@@@@@@@@@@@@@@@@@@@@@@@@@@@@@@@@@@@@@@@@@@@@@@@@@@@@@@@@@@@@@@@@@@@@@@@@@@@@@@@@@@@@@@@@@@@@@@@@@@@@@@@@@@@@@@@@@@@@@
@I........................................................................................@.....................................
@.........................................................................................@.....................................
@.........................................................................................@.....................................
@.........................................................................................@.....................................
@.........................................................................................@.....................................
@.........................................................................................@.....................................
@.........................................................................................@.....................................
@.......@.......@.......@@@@@@@@@@@@@@@@@@@@@@@@@@@@@@@@@@@@@@@@@@@@@@@@@@@.......@.......@........@.......@.......@@@@@@@@@@@@@
@.......@.......@........................@................................@.......@.......@........@.......@....................
@.......@.......@........................@................................@.......@.......@........@.......@....................
@.......@.......@........................@................................@.......@.......@........@.......@....................
@.......@.......@........................@................................@.......@.......@........@.......@....................
@.......@.......@........................@................................@.......@.......@........@.......@....................
@.......@.......@........................@................................@.......@.......@........@.......@....................
@.......@.......@........................@................................@.......@.......@........@.......@....................
@.......@@@@@@@@@@@@@@@@@........@@@@@@@@@.......@@@@@@@@@@@@@@@@@@.......@.......@@@@@@@@@........@.......@@@@@@@@@@@@@@@@@....
@...............@.......@........@...............@................@...............@................@.......................@....
@...............@.......@........@...............@................@...............@................@.......................@....
@...............@.......@........@...............@................@...............@................@.......................@....
@...............@.......@........@...............@................@...............@................@.......................@....
@...............@.......@........@...............@................@...............@................@.......................@....
@...............@.......@........@...............@................@...............@................@.......................@....
@...............@.......@........@...............@................@...............@................@.......................@....
@.......@@@@@@@@@.......@@@@@@@@@@.......@@@@@@@@@.......@........@@@@@@@@@.......@.......@@@@@@@@@@@@@@@@@@@@@@@@@@.......@@@@@
@.......@...............@................@...............@........................@.......@........................@............
@.......@...............@................@...............@........................@.......@........................@............
@.......@...............@................@...............@........................@.......@........................@............
@.......@...............@................@...............@........................@.......@........................@............
@.......@...............@................@...............@........................@.......@........................@............
@.......@...............@................@...............@........................@.......@........................@............
@.......@...............@................@...............@........................@.......@........................@............
@.......@...............@................@...............@........................@.......@........................@............
@.......@.......@@@@@@@@@........@@@@@@@@@.......@@@@@@@@@@@@@@@@@@@@@@@@@@@@@@@@@@.......@........@.......@@@@@@@@@@@@@@@@@....
@...............@................@................................................@................@...............@............
@...............@................@................................................@................@...............@............
@...............@................@................................................@................@...............@............
@...............@................@................................................@................@...............@............
@...............@................@................................................@................@...............@............
@...............@................@................................................@................@...............@............
@...............@................@................................................@................@...............@............
@.......@@@@@@@@@.......@@@@@@@@@@@@@@@@@@@@@@@@@@@@@@@@@@@@@@@@@@@@@@@@@@@@@@@@@@@.......@@@@@@@@@@@@@@@@@@@@@@@@@@.......@@@@@
@.......@...............@.........................................@...............@.......@........@...............@............
@.......@...............@.........................................@...............@.......@........@...............@............
@.......@...............@.........................................@...............@.......@........@...............@............
@.......@...............@.........................................@...............@.......@........@...............@............
@.......@...............@.........................................@...............@.......@........@...............@............
@.......@...............@.........................................@...............@.......@........@...............@............
@.......@...............@.........................................@...............@.......@........@...............@............
@@@@@@@@@.......@@@@@@@@@........@@@@@@@@@@@@@@@@@@@@@@@@@........@.......@.......@.......@........@.......@.......@@@@@@@@@....
@.......................@........@.......@........................@.......@.......@................@.......@....................
@.......................@........@.......@........................@.......@.......@................@.......@....................
@.......................@........@.......@........................@.......@.......@................@.......@....................
@.......................@........@.......@........................@.......@.......@................@.......@....................
@.......................@........@.......@........................@.......@.......@................@.......@....................
@.......................@........@.......@........................@.......@.......@................@.......@....................
@.......................@........@.......@........................@.......@.......@................@.......@....................
@.......@@@@@@@@@@@@@@@@@@@@@@@@@@.......@@@@@@@@@.......@@@@@@@@@@.......@.......@.......@@@@@@@@@@.......@@@@@@@@@@@@@@@@@@@@@
@................................................@.......@................@.......@................@............................
@................................................@.......@................@.......@................@............................
@................................................@.......@................@.......@................@............................
@................................................@.......@................@.......@................@............................
@................................................@.......@................@.......@................@............................
@................................................@.......@................@.......@................@............................
@................................................@.......@................@.......@................@............................
@................................................@.......@................@.......@................@............................
@.......@@@@@@@@@@@@@@@@@........@@@@@@@@@@@@@@@@@.......@@@@@@@@@@@@@@@@@@.......@.......@........@.......@.......@@@@@@@@@....
@...............@.......@........................@.......@........................@.......@........@.......@.......@............
@...............@.......@........................@.......@........................@.......@........@.......@.......@............
@...............@.......@........................@.......@........................@.......@........@.......@.......@............
@...............@.......@........................@.......@........................@.......@........@.......@.......@............
@...............@.......@........................@.......@........................@.......@........@.......@.......@............
@...............@.......@........................@.......@........................@.......@........@.......@.......@............
@...............@.......@........................@.......@........................@.......@........@.......@.......@............
@.......@.......@.......@@@@@@@@@@.......@.......@.......@@@@@@@@@@@@@@@@@@.......@@@@@@@@@@@@@@@@@@@@@@@@@@@@@@@@@@.......@@@@@
@.......@...............@................@........................................@................................@............
@.......@...............@................@........................................@................................@............
@.......@...............@................@........................................@................................@............
@.......@...............@................@........................................@................................@............
@.......@...............@................@........................................@................................@............
@.......@...............@................@........................................@................................@............
@.......@...............@................@........................................@................................@............
@@@@@@@@@@@@@@@@@.......@@@@@@@@@@.......@@@@@@@@@@@@@@@@@@@@@@@@@@@@@@@@@@@@@@@@@@.......@........@@@@@@@@@.......@.......@....
@...............@.......@........@...............@................................@.......@........@.......................@....
@...............@.......@........@...............@................................@.......@........@.......................@....
@...............@.......@........@...............@................................@.......@........@.......................@....
@...............@.......@........@...............@................................@.......@........@.......................@....
@...............@.......@........@...............@................................@.......@........@.......................@....
@...............@.......@........@...............@................................@.......@........@.......................@....
@...............@.......@........@...............@................................@.......@........@.......................@....
@@@@@@@@@.......@.......@........@.......@.......@@@@@@@@@........@.......@@@@@@@@@.......@........@@@@@@@@@@@@@@@@@@@@@@@@@@@@@
@...............@................@.......@...............@........@.......................@.....................................
@...............@................@.......@...............@........@.......................@.....................................
@...............@................@.......@...............@........@.......................@.....................................
@...............@................@.......@...............@........@.......................@.....................................
@...............@................@.......@...............@........@.......................@.....................................
@...............@................@.......@...............@........@.......................@.....................................
@...............@................@.......@...............@........@.......................@.....................................
@...............@................@.......@...............@........@.......................@.....................................
@.......@@@@@@@@@@@@@@@@@........@@@@@@@@@@@@@@@@@.......@........@@@@@@@@@.......@@@@@@@@@........@@@@@@@@@@@@@@@@@@@@@@@@@....
@.......................@................@...............@........@.......@...............@........................@............
@.......................@................@...............@........@.......@...............@........................@............
@.......................@................@...............@........@.......@...............@........................@............
@.......................@................@...............@........@.......@...............@........................@............
@.......................@................@...............@........@.......@...............@........................@............
@.......................@................@...............@........@.......@...............@........................@............
@.......................@................@...............@........@.......@...............@........................@............
@.......@@@@@@@@@@@@@@@@@........@@@@@@@@@.......@@@@@@@@@........@.......@@@@@@@@@.......@@@@@@@@@@@@@@@@@@@@@@@@@@.......@....
@.......@........................@...............@................................@................@.......................@....
@.......@........................@...............@................................@................@.......................@....
@.......@........................@...............@................................@................@.......................@....
@.......@........................@...............@................................@................@.......................@....
@.......@........................@...............@................................@................@.......................@....
@.......@........................@...............@................................@................@.......................@....
@.......@........................@...............@................................@................@.......................@....
@.......@.......@@@@@@@@@@@@@@@@@@@@@@@@@@.......@@@@@@@@@@@@@@@@@@@@@@@@@@.......@@@@@@@@@@@@@@@@@@.......@@@@@@@@@@@@@@@@@....
@...............@........................@.......@................@...............@................@...............@............
@...............@........................@.......@................@...............@................@...............@............
@...............@........................@.......@................@...............@................@...............@............
@...............@........................@.......@................@...............@................@...............@............
@...............@........................@.......@................@...............@................@...............@............
@...............@........................@.......@................@...............@................@...............@............
@...............@........................@.......@................@...............@................@...............@............
@@@@@@@@@.......@@@@@@@@@........@@@@@@@@@.......@.......@........@@@@@@@@@@@@@@@@@.......@........@@@@@@@@@.......@@@@@@@@@....
@................................@.......................@................................@................................@....
@................................@.......................@................................@................................@....
@................................@.......................@................................@................................@....
@................................@.......................@................................@................................@...G