120,80
...H.A.H....A..H@.H..H.......H...H..@HH...H..A......A...@....A.H..HH.A......@......H..H..AAA....@.A...H.....AH......@..........HH...H...@.A.....H.A....H..A.@...
A......H....AA..@..H.H............HA@.........H..A......@.............A.....@HH.H......A........@.H...H..A.........A@H.....A..AAA.AA.A.A@...A.H...AHH...A..A@.H.
@.@@@@@@@@@H....@..A@.@@@@@@@@@.....@.AA@.@@@@@@@@@.....@...@.@@@@@@@@@H....@...@.@@@@@@@@@.....@.A.@.@@@@@@@@@A.H..@...@.@@@@@@@@@..A..@..H@.@@@@@@@@@..H..@.H.
.H...H....@H........A......H..@.A...............H.@.H....HH.A....A....@H.A......A..H..HAH.@H.....H.AA.....A..A@...H.....H.....H...@.........A.........@........A
.A.....A.A@@@@@@@@@@...AHA.H..@@@@@@@@@@..AH...A..@@@@@@@@@@..........@@@@@@@@@@.......H..@@@@@@@@@@.H..A.H.A.@@@@@@@@@@...H....H.@@@@@@@@@@......A...@@@@@@@@@@
...HHA......H...H..A..A....A....A....A.HH....................H................AH.......A...............H.....H...A..HA.......H.........H..A.........H........A..
@@@@@@@@@@@@HH@@@@@@@@@@@@@@@@@@.H@@@@@@@@@@@@@@@@@@..@@@@@@@@@@@@@@@@@@.H@@@@@@@@@@@@@@@@@@..@@@@@@@@@@@@@@@@@@..@@@@@@@@@@@@@@@@@@..@@@@@@@@@@@@@@@@@@H.@@@@@@
....A......@.H@A..H.A..A..H...AAHA@...A...........A@..@....H...H.H..H.H...@..A...H.........@A.@...A...............@........H.A.....@.H@..A.H...H...A....H.@..A..
.H.........@H.@A..............A@.A@.....H...H......@..@......A.......H.@..@.A.A...A......H.@..@...............H@H.@..HH.HH.A..A....@A.@.....HH....A.AA.@.A@.....
A.AH...H.H.A.......AHA..HAHH...@A..H...H...HH.H...............A........@H.....A.HA.............AH....H.H....H..@.HH.H................A........A..A...H.@.......H
@@@@@@@@@@@@..@@@@@@@@@@@@@@@@@@..@@@@@@@@@@@@@@@@@@..@@@@@@@@@@@@@@@@@@..@@@@@@@@@@@@@@@@@@.H@@@@@@@@@@@@@@@@@@H.@@@@@@@@@@@@@@@@@@..@@@@@@@@@@@@@@@@@@..@@@@@@
..A..HA....@..@.....A....H.A...@.A@....H.......H.H.@..@...HA........H..@.H@......A...A.H...@A.@..........A.....@..@..H.....H.HA...A@..@.......A.H......@H.@.....
...........@H.@....H...A..AAH..@..@........A.A.A.A.@..@..H.HHA.H...H...@.H@...A.....H..H...@..@.....A.......H..@..@.......A.....AAA@..@......H........H@A.@H.H..
.AHH..H.....A.............H........H....HH...............H.............A......H.......H......A...AAA....AH..A.......H...A......HA.A........H.....H.....H.....H..
@@@@@@@@@@@@H.@@@@@@@@@@@@@@@@@@.A@@@@@@@@@@@@@@@@@@..@@@@@@@@@@@@@@@@@@..@@@@@@@@@@@@@@@@@@.H@@@@@@@@@@@@@@@@@@..@@@@@@@@@@@@@@@@@@..@@@@@@@@@@@@@@@@@@..@@@@@@
..H....AH..@..@..H..H..A..........@........H....A..@..@.HA.A..............@HH..A..H..AH.H..@..@H.H...H........H..H@.....A...A.....H@A.@A....H...........A.@.....
......A....@..@.H..A...H.......@..@...A.H...HH.AH.H@..@................@..@..AHA.......A.H.@..@.H....H...H....A@.A@......H.AH......@..@H.H...A.H...A.A.@..@A..HH
H.......A.AHA..............H...@.H...A..A...H....A.......A...A.....A..H@..HA.....AA......A.......AA...A.H......@H.....A..H..............H..A...H.......@......A.
@@@@@@@@@@@@..@@@@@@@@@@@@@@@@@@H.@@@@@@@@@@@@@@@@@@..@@@@@@@@@@@@@@@@@@..@@@@@@@@@@@@@@@@@@..@@@@@@@@@@@@@@@@@@.H@@@@@@@@@@@@@@@@@@.H@@@@@@@@@@@@@@@@@@..@@@@@@
....A.....H.....................A........H....AA.........A........AH.H.....H....A.....A....HH.A.........HHA.H....A..A.....A..AH..........A...AH.A......H...A....
..A.AA...H......@..A.....A.AH.......@.....H....A.A....HA@..........A..H.A...@....AAH.....H......@......A........A..A@...H.A...A....AA...@H...A.A......HHH...@.H.
.A....A.........@.H..AH...H.........@A.A.H..H...A..A....@.......A.......H...@....AH..H..........@H...H..A.H..HH.H.HA@.......H.....H..A..@HA....H...H...AHA..@A..
@.@@@@@@@@@..A.H@.A.@.@@@@@@@@@..HA.@...@.@@@@@@@@@...A.@A.H@.@@@@@@@@@.....@HH.@A@@@@@@@@@H....@...@.@@@@@@@@@..A..@...@.@@@@@@@@@.A...@A..@A@@@@@@@@@.....@.A.
..HA......@....H.......HA....A@...H..........A....@.......AA..........@.HH.....H..........@........A......H...@...................@.......A.....A..H..@..H......
.A.H......@@@@@@@@@@H....H..H.@@@@@@@@@@A.....A.H.@@@@@@@@@@.H...A...A@@@@@@@@@@...A.H....@@@@@@@@@@.A....A...@@@@@@@@@@..HA......@@@@@@@@@@.A........@@@@@@@@@@
......................A.H...A......H.A..A......H.HAH.A.HH..A...AH.......AH..........H.H...H............A..............HA.....HAA...A.......A..A.................
@@@@@@@@@@@@..@@@@@@@@@@@@@@@@@@.H@@@@@@@@@@@@@@@@@@AH@@@@@@@@@@@@@@@@@@..@@@@@@@@@@@@@@@@@@.A@@@@@@@@@@@@@@@@@@H.@@@@@@@@@@@@@@@@@@H.@@@@@@@@@@@@@@@@@@..@@@@@@
....A...A..@..@........A..A.......@.....A..H.......@..@AH....A..H...A...A.@...A..H....H...H@..@.H...H........H....@.A...A......AA..@.A@A.A..A........H....@....A
.H.H...HHA.@..@.H......HH.H...A@H.@.A..H..A.....AH.@..@A....AA.H..A.AA.@.H@H.H...........A.@..@.AH.........H.A.@..@H....A.H........@.H@.........A....A.@..@.H...
.............H......H...H.A....@....AH...AH..HH.HAA..........HA.....HH.@............A........H.H....A..H.......@.....H.......AA....HA.......AH..A......@..AAA.A.
@@@@@@@@@@@@A.@@@@@@@@@@@@@@@@@@..@@@@@@@@@@@@@@@@@@..@@@@@@@@@@@@@@@@@@..@@@@@@@@@@@@@@@@@@..@@@@@@@@@@@@@@@@@@..@@@@@@@@@@@@@@@@@@..@@@@@@@@@@@@@@@@@@..@@@@@@
.H....H....@H.@..A.........A.A.@..@..........H..AH.@.A@...H.A..A.A....H@..@......HAH..A..A.@H.@.A............A.@..@...H..H....A....@..@HH......H....A..@..@...AH
......AA...@..@......H.H.....H.@..@....H..H........@..@............H.A.@..@.....A....A.....@..@...A.......HH.A.@..@.....H....A...A.@..@.HHAH......A....@A.@....H
......H.H.H.H..H.......AH..HHH...A.H........H....H.A.............AA....H.....H..H...A......H..HH...A..H...H.A........H....A...A.A.AH....H...HH....A.A.H...H.....
@@@@@@@@@@@@.A@@@@@@@@@@@@@@@@@@..@@@@@@@@@@@@@@@@@@.H@@@@@@@@@@@@@@@@@@H.@@@@@@@@@@@@@@@@@@H.@@@@@@@@@@@@@@@@@@.H@@@@@@@@@@@@@@@@@@..@@@@@@@@@@@@@@@@@@H.@@@@@@
......A...H@A.@A.......A....HA.H..@A..........HH...@..@..A....H....A......@.A..............@..@...A.A..........H..@................@.A@.H.H....H..H.A.A...@...AA
.....HH....@H.@...A....H.......@.A@.H...A.HH..H...H@..@........A..H....@..@........H.......@.H@H..H..H....H....@..@..A.......A..HHA@..@A......H.A.HA...@..@...AH
AA...HAA.......H.A....A.HAH....@.......A.A........AA.........HA.H......@............H.........H.....H..A.....H.@.AA....A......A..H.....A.AAA...........@H..AH...
@@@@@@@@@@@@.H@@@@@@@@@@@@@@@@@@..@@@@@@@@@@@@@@@@@@..@@@@@@@@@@@@@@@@@@.H@@@@@@@@@@@@@@@@@@..@@@@@@@@@@@@@@@@@@.H@@@@@@@@@@@@@@@@@@..@@@@@@@@@@@@@@@@@@..@@@@@@
.....A.H....H.H..A.........A.H...A.......H.....A..........H..H.....HHA....H...........HA...HAA.A.H......A...............H.....HH....A......A......HAH..H..A....H
........A.......@....H........A.....@.........H.........@A.....A.A.H.......A@...A..........H..H.@.H......H...H.....A@.........A.A..H....@......A.AAH........@...
.......A.H.H....@.A.H...A..H...A..H.@...AHHH..A.......A.@..A.....AH...H.....@......A..A.....A...@.......A...H.A.....@.........A.....H.A.@..A............A...@A..
@A@@@@@@@@@.....@...@.@@@@@@@@@...AH@..H@A@@@@@@@@@.....@...@.@@@@@@@@@H....@...@.@@@@@@@@@....H@...@.@@@@@@@@@.....@.A.@.@@@@@@@@@A...A@.HA@.@@@@@@@@@...A.@.H.
....A.A.A.@..A.A.H.A...A......@.....HA........H..H@.A..........HA..H..@...H.........A.H.H.@A.H..A......H...A.A@..A.AH.HA....H.....@........AA.........@...H.HH..
.......H..@@@@@@@@@@..........@@@@@@@@@@..H....H..@@@@@@@@@@....HA....@@@@@@@@@@H..H...A..@@@@@@@@@@..........@@@@@@@@@@........A.@@@@@@@@@@......H...@@@@@@@@@@
H.A....A.H.AH...A.H....H.................A........H........A...H...A.......A..AA...AA..A.HHH...H...H...A..A.....H...H..H.AA...A.A....AH...A....HA...H...H....AA.
@@@@@@@@@@@@.A@@@@@@@@@@@@@@@@@@H.@@@@@@@@@@@@@@@@@@..@@@@@@@@@@@@@@@@@@..@@@@@@@@@@@@@@@@@@A.@@@@@@@@@@@@@@@@@@H.@@@@@@@@@@@@@@@@@@..@@@@@@@@@@@@@@@@@@..@@@@@@
A...AAA....@..@....A...H.......H..@.A.A............@..@.....AH......HA....@A...A..........A@..@.A...AH...A....A...@..HAHH........H.@..@..H...HH...HH.....A@...HA
A...AA...A.@..@H..AH..A........@H.@H......H.AH....H@A.@A.HA........HA..@A.@.............H..@..@H.........HA..A.@..@........HH...H..@.H@H..AA.......A..A@..@.....
..H..AHH...AA..A..H.H..A.......@...............HH.H....H.....A.........@H.......A...H.AH....H.....H.H.H.H.A.H..@..A........A...........HAH.H.......A...@..H.A.A.
@@@@@@@@@@@@..@@@@@@@@@@@@@@@@@@..@@@@@@@@@@@@@@@@@@..@@@@@@@@@@@@@@@@@@H.@@@@@@@@@@@@@@@@@@..@@@@@@@@@@@@@@@@@@..@@@@@@@@@@@@@@@@@@..@@@@@@@@@@@@@@@@@@..@@@@@@
....A......@..@.HH....AA.......@..@.H.........H....@A.@AHA.H......A.H..@A.@H...HHAHAH......@..@H...............@..@.H..H.H..H.AH...@..@..............AA@..@.....
.......HH..@.H@...........A....@H.@................@AH@..............A.@..@.....H....H.A..A@.H@.....H.A..H..H..@..@....H...........@..@.....HH.A....A.A@.A@.A...
...AA...A.....A....AH.H......AHAA.A.................A.......H..A......H...A.H.AH.......A.........H................H....A.AHA...H.H....A...............A......A..
@@@@@@@@@@@@..@@@@@@@@@@@@@@@@@@..@@@@@@@@@@@@@@@@@@..@@@@@@@@@@@@@@@@@@..@@@@@@@@@@@@@@@@@@..@@@@@@@@@@@@@@@@@@H.@@@@@@@@@@@@@@@@@@..@@@@@@@@@@@@@@@@@@HH@@@@@@
.A...A....H@.H@A......A......A..A.@A.......A.AA....@A.@...............H...@.A.........H.H..@A.@..........A..H.A...@AH..A.A........A@H.@..............H....@.....
H..A....H.A@.A@..H....A.....A..@..@........H.H.....@H.@..........H...HA@..@A.....AA.....H..@..@.......H.H.A...A@.H@..HA...AA..A....@..@.A..A...HA....A.@A.@....A
...A.....A..A..A............A..@.H...HH.H.......A.A.AH...H............A@..A...........................A........@.......H..HAH.A.......H.AA.A...A..H....@........
@@@@@@@@@@@@.A@@@@@@@@@@@@@@@@@@H.@@@@@@@@@@@@@@@@@@..@@@@@@@@@@@@@@@@@@H.@@@@@@@@@@@@@@@@@@.A@@@@@@@@@@@@@@@@@@..@@@@@@@@@@@@@@@@@@.A@@@@@@@@@@@@@@@@@@..@@@@@@
...........H.H.H...H.A......A...............A..AA.........HA..H........A...................H.............H....A...............H...A...........A...H......AH.H..H
.H....A........H@.A.A..H.H..A......H@.A..A.H...A.H......@A............A.....@.......A...........@.H.A.H......H......@....H...AH....A....@.......A.A.....HA..@.H.
..A..AH.....H...@..HH.AA......H..H..@.......A.......H.A.@..A........HHH.H...@.....H.....H..A....@......A....H.......@A..H..H...AA.A....H@....H..............@...
@A@@@@@@@@@...AA@...@.@@@@@@@@@.....@H.H@.@@@@@@@@@H..A.@...@.@@@@@@@@@AHHAH@...@.@@@@@@@@@A....@...@.@@@@@@@@@.....@.A.@.@@@@@@@@@.....@H..@.@@@@@@@@@.....@...
....A....A@..H................@............H...HH.@H....A.A.......A...@.H.A....H......H..H@..HH.........H.....@..........AH......H@....A.......A......@H.....AH.
....HAHA..@@@@@@@@@@A.....H...@@@@@@@@@@..H.A....A@@@@@@@@@@.....A...A@@@@@@@@@@AH.HA.....@@@@@@@@@@H.AH...AH.@@@@@@@@@@..H......H@@@@@@@@@@.A.H..A...@@@@@@@@@@
H.....A..........HA..A..A..........H................A.........HAAA....A......A.A.A...H..........A..A.H.H..H.A...........H.......A..A.....A...A.........H.HAA...H
@@@@@@@@@@@@..@@@@@@@@@@@@@@@@@@A.@@@@@@@@@@@@@@@@@@..@@@@@@@@@@@@@@@@@@..@@@@@@@@@@@@@@@@@@..@@@@@@@@@@@@@@@@@@..@@@@@@@@@@@@@@@@@@..@@@@@@@@@@@@@@@@@@..@@@@@@
..A..A..A..@.A@.HH.............H..@..HH.H........A.@..@...H.......A.......@.......A..A..H.A@..@A.A.......A.H..HH..@...H..........HA@..@..........A...A....@..A.H
AA.H..H....@..@..A.H.A.H.....A.@.A@..AHA.........A.@..@....H........A..@..@...H............@..@.....H..A.......@..@......HA..A.H...@..@.....A..........@..@H...A
..H.AH.............H.H...HA.A..@.H............HH..........H...........A@A...........H.A.A...A....A.............@.HA........A..A....A.......A.....H...A.@.H......
@@@@@@@@@@@@..@@@@@@@@@@@@@@@@@@HA@@@@@@@@@@@@@@@@@@..@@@@@@@@@@@@@@@@@@..@@@@@@@@@@@@@@@@@@.H@@@@@@@@@@@@@@@@@@.A@@@@@@@@@@@@@@@@@@..@@@@@@@@@@@@@@@@@@..@@@@@@
...........@..@...........H....@..@...........AAHA.@H.@...H.........A..@..@A...AHAA...A....@..@.........A......@..@....H...H..HHH..@..@...H....AA.HA.HA@..@.....
A......AHA.@..@..A...H.A.A....A@H.@..H...........H.@..@H.A..A...H......@AH@.H...A...H.A.H..@H.@...........H....@..@H.......A......H@.A@...........H.H..@A.@AA..H
....H...........A........H...H.....A.AH..HAA.H..A...H..A.....AA..................H.....H......H..H...A..H.....H........A............A..H......A...H.A..AA..H...H
@@@@@@@@@@@@..@@@@@@@@@@@@@@@@@@..@@@@@@@@@@@@@@@@@@..@@@@@@@@@@@@@@@@@@A.@@@@@@@@@@@@@@@@@@.H@@@@@@@@@@@@@@@@@@..@@@@@@@@@@@@@@@@@@..@@@@@@@@@@@@@@@@@@..@@@@@@
...A.....H.@.A@...........AA.H...H@...........A..A.@..@..H................@.............HHH@..@...........H..H....@H.A....A.H......@AA@.A.H....H..........@.....
...........@..@..A.............@..@.....HH.........@.H@.....AH.H.......@H.@A.A.........H...@..@....AA.HH.A.....@.H@..HHA...........@..@...H..A.H.A.....@..@...H.
...AA.......A.......H......A.A.@................H...................H..@H...........A.H....A...A.....A....A....@....H....A.............A......A.....H..@..H.H...
@@@@@@@@@@@@..@@@@@@@@@@@@@@@@@@..@@@@@@@@@@@@@@@@@@..@@@@@@@@@@@@@@@@@@..@@@@@@@@@@@@@@@@@@HA@@@@@@@@@@@@@@@@@@..@@@@@@@@@@@@@@@@@@..@@@@@@@@@@@@@@@@@@..@@@@@@
H.....HH.H...H..H.A.......A.....H....A............A..A.......A..............AH..A.....A.......A...A..A............H.A.........H.......A..A..H......H............
