512,512
@@@@@@@@@@@@@@@@@@@@@@@@@@@@@@@@@@@@@@@@@@@@@@@@@@@@@@@@@@@@@@@@@@@@@@@@@@@@@@@@@@@@@@@@@@@@@@@@@@@@@@@@@@@@@@@@@@@@@@@@@@@@@@@@
@.A..A..A.A...H.@....H.........A@...A.H...H..A..@H..H........A..@H.....A.....H..@...H.....A.H...@......A......A.@..A...A...H....
@A..A...........@.A.......H.....@...H.H..AA.H.H.@..AH...H.......@.HH.A.....A....@..HA...H......A@.............A.@H..............
@.AH...H........@.A.............@.HH.....A......@...H...A.A.H...@..H..A.......A.@..AHH.A........@..............H@....HA.H.A..H..
@.....AA.A..AA..@......AH.H.....@.....H...AA.A..@...............@....A....A....A@HA..HH...H.....@...HH.A...A....@....HA.........
@.....H.H...A...@..A....HA...H..@..........H.H..@.H...H.......H.@....A.....H.A..@...H...........@..HA........A.A@H..........A...
@.A....A........@...A..H.......A@H..H.....A.....@...........H...@....H....A....A@..AA..A..H.H..A@..H......H..AA.@H.....A....A...
@..A..HH.A..H...@...A.HA..H.....@H...A.H..H..H..@.HA...........H@........H......@H.......HH.....@.......H...H...@A...H..........
@....H..A...AA..@...A......AA...@HH.....H..A....@A........A.AH..@A..A...H.....A.@.A.....H......H@......H..A....H@HA.......A.AH..
@..H........H..H@.HA..H..H.....H@.A.........H...@........A......@H.A....H.......@........A....H.@H...........AH.@..AA..A.......A
@.H.A......H....@...............@.H..A.........A@...H....A..H..A@...A....AH..A..@H.....A........@..........A..A.@.........H.AA..
@.A...A..A......@..HA......HA...@.........A..H..@....H..A.H....H@..AH........HH.@.....H.A.......@.A.AA.AHHA.H...@...H.H....A....
@.....H.H..AH.A.@.....H......H..@...H..........H@.....AA...AA.A.@..........A.A..@...........H...@........A......@...AH...AH.....
@...A..........A@....H.H..H.....@...............@.AH...H.AH.....@.....HH........@A.H....A....A..@.AH......A...H.@......H..H.....
@...............@HH..AH.........@....A.....A....@..AH...........@H.....AH.....H.@H............H.@.H....AA.A.....@.H..A..H...AA..
@........A.....A@...A........HH.@H......H.AHH...@......A....H...@...A....A......@.........HA....@........A..H.HA@A............HA
@@@@@@@@@@@@@@@@@@@@@@@@@@@@@@@@@@@@@@@@@@@@@@@@@@@@@@@@@@@@@@@@@@@@@@@@@@@@@@@@@@@@@@@@@@@@@@@@@@@@@@@@@@@@@@@@@@@@@@@@@@@@@@@@
@A...A...HA.....@....H......H.H.@...A...H.......@.....H.......A.@........H....AA@....A..........@...H...H...A...@A.....HH...H...
@H....H.H.A.....@...H....AA.....@....HHH....A...@....HHA...AH.A.@H........A.....@....H..A.......@....A.A......H.@.....H.........
@....A.........H@..A.H.A...A.A..@.........H.....@AAA..AH........@..H.....A......@...........H...@...AHH..A.HA..H@.....HH.A......
@....H.A........@.....H....H....@..............A@A...H..........@..H.H..AAH..A..@............H..@A..........H.A.@....H..H...A...
@............AHA@........HA.....@A...........HA.@...............@HHA..A.A..A....@.....A..A......@.H....H.A.A.H..@H.......A.....H
@A..A.H..AH.....@A.H..H.H..HA..H@....AH..H.H....@..H.........H..@.H..........A..@.A............A@...A.....HH....@A.A.H....H.A...
@.A..A.A......AA@.............H.@......HH....AA.@.........A..A.A@..A............@..A...........H@HH.A..HHA......@....H....A.....
@...............@.......A.A.A...@.......H...A...@.......H.A.....@A.......H...H..@.........H.H...@...H.......A.A.@......H..HHH...
@....H....A.H...@...............@....A.A..H.....@..........A....@............A..@.A.A..H.H......@......A....AHH.@H...A.........A
@...H.......HH..@H..............@.AH............@........AA.....@.H.A.H....H....@A......H.H...H.@A....H.........@..A..H.H.A.A...
@........H......@..............A@......A...H....@A...........AH.@.A.......H.....@.......A.......@...........H.H.@........AH.....
@........AAA...H@..A....HH......@..H........A...@......A.H...A.H@H..A.........H.@...........A...@...A.AA........@A....H..A.....H
@......HAH....H.@..A...A...A....@....H.H...H....@............A..@..A............@..A....A.......@AH.......A...A.@H..AA...H..A...
@.A.....H.A..AH.@.....H...H.....@......H....A...@..AA...........@....HAH...AA...@A.A...A.....AH.@........H.H....@...HHA..A......
@..H.......AA.H.@......H.A..AHH.@........H......@....A.A.....AA.@..A..A.....A.A.@..H.A...A......@........HA.....@.HA.A...AAA..AA
@@@@@@@@@@@@@@@@@@@@@@@@@@@@@@@@@@@@@@@@@@@@@@@@@@@@@@@@@@@@@@@@@@@@@@@@@@@@@@@@@@@@@@@@@@@@@@@@@@@@@@@@@@@@@@@@@@@@@@@@@@@@@@@@
@............H.H@.........H.H.A.@..H....AHA.....@...H.H....A...H@..H............@......H.A..A...@..H....A....H.H@....HA....H....
@A..............@H..H....HA..A..@..A......A..A..@..A.....A....AA@......H.......A@..A...H.A.....A@H..............@...A...........
@..H...AH.......@..........A..A.@A.......AA..AH.@.HH.....HA....A@.A...A.H.....H.@H..H...........@.....A...H...H.@.H.H......A....
@....A..AA......@..........H....@...............@......A.....H..@.HH...HH..A....@....H.....A....@.H.............@.H..AHA...A...H
@.....H.....A...@.....HA........@..A............@....A..H..H.A..@....A.....A..A.@.....H.........@.H...A...AA.H.A@......AA.......
@.H..H..H.A...H.@...A...........@..A....A.......@.A...........H.@.A..........A..@....AA...A.H..A@..A.....H.AA...@A.A.A.A...A..A.
@.A....A.H..A..A@...A..H..H.....@............H..@A...A.......A..@.........HH....@..HA...........@H....H..AH.HA.H@...A...H..H...H
@............A.H@.........H.....@HA......A......@.............H.@....H.....A.A..@.....A.AA......@..AA.....A.....@.HAA......H....
@.....AAA..A....@.........AH..H.@...........A...@......A..A.AH..@...........A...@H....H...H.....@...H......AH...@.......H..H....
@....H.HH......A@H........A..HH.@...A...........@.AAH.A.......A.@...........H...@.......HA...H..@.A......H.H.H..@A.A.....HH.....
@.H...A.........@.....AA........@....A...A...HA.@.....AA....H...@........H.H.H..@...H..AA.......@....A..........@.............A.
@H..HA.......A..@...AHA...H.....@.......AH......@...H...........@A...A...H...A..@..A............@...............@....H....AA...A
@.....A......A..@H.A...H...A..H.@......H.A......@A.....A....A...@...HH........H.@.AA.....HH.....@A......H.H.....@...A....A.H.A..
@A......A....H..@...H...HA.A..A.@........HA.A...@A..........A...@....H.......A..@...A.....H..A.H@..AA..H..H....H@.......A.......
@.H......H.....A@A.A.HA...A....H@...H........A..@.A.....HA..HHH.@A.....A..H...AH@..A...H......A.@.......H.A.....@..H...A.A......
@@@@@@@@@@@@@@@@@@@@@@@@@@@@@@@@@@@@@@@@@@@@@@@@@@@@@@@@@@@@@@@@@@@@@@@@@@@@@@@@@@@@@@@@@@@@@@@@@@@@@@@@@@@@@@@@@@@@@@@@@@@@@@@@
@......H.HA.H...@.H..AH.........@AH..........H..@....A..........@.....H.........@.H..HA....A..HH@.A.......H.....@...............
@....A...H..HA..@........A......@..A...........H@....H..H...H...@.A....H.......A@....HA.........@.....H...A.....@H.......A......
@.....AH..A.....@A.....H.H...AH.@.......A...AH.A@..H......A...H.@A.H............@....H.......A..@.......A...A...@....H........A.
@.AAA....H...AH.@H......A.......@..H...H........@...............@...H...HA..H...@.............A.@..A.....A.A.A..@A..............
@........AA.....@.A......A.....H@H..H.H.....H..H@...HH..........@.............H.@.HH.A..H......H@..........H..H.@H..A.A.......H.
@........A.....H@.A..A.A.H.H.H.H@.H....H........@.............AA@...H.HA....H..A@.....A......HA.@A...AA.H.......@.........H.H...
@..A....A.....HH@....HA....A.A..@H...A....H...A.@.A.......A.....@A..........AH..@AA....AH.H.....@....AH........A@........H.H....
@..AA.H.......H.@...A.A........A@A.....A...A....@......A......A.@.AA............@...A....A...A..@A....H....H..A.@.....H....A....
@...A.....A..A.A@.A.......H.H.A.@.....H.A.......@H..H...H....A..@........AH.....@A..H.......A...@...H..........A@........H......
@..A..AHA.....AA@....A.H.A......@AA.....AH......@........A.A.HA.@..H..H..H.H.H..@....HH..H......@...............@.A......AAA..A.
@A.....H..A..A..@AHH....H.A.....@....H....A.H...@..A.A.HH.H.....@.......A.......@.....A..A...H..@..A..........H.@..H.........A..
@...............@.....H.........@...H.H.H.......@......A...H....@.H....A........@..........H....@....H......A.A.@...H.A......AA.
@H...H.H........@....A.A..HH....@....A.....H....@.....A..A..H...@H..........H.HA@...............@..A........H...@.H...A.........
@A.....H........@AA.....H...HA.A@.........A.....@A...A...H.AH...@...........H...@....H....H.....@....H.....H....@..AA..A........
@.A......A......@.H....HAH..A...@.....AA......HH@....A.A........@........H....AA@.....A.HH...A..@....H....A.A.H.@.......HH..A..H
@@@@@@@@@@@@@@@@@@@@@@@@@@@@@@@@@@@@@@@@@@@@@@@@@@@@@@@@@@@@@@@@@@@@@@@@@@@@@@@@@@@@@@@@@@@@@@@@@@@@@@@@@@@@@@@@@@@@@@@@@@@@@@@@
@.A....A.....H..@....AH.........@A.......H.....H@A........A..A..@.......A..A...A@.....A........H@H.HAH..H.....H.@....A....HA...A
@....H...H.AA..A@.......A..A...A@.....H....A.A..@A..........HA..@......A...A..H.@...H.A.....H..H@..AA.H.HHA...HH@..H......H.H...
@...A.H......H..@..H..AA..A.A.A.@.AH..HH..H...A.@...H...H.......@...H........AH.@..AA..H..H...A.@...A....AA.H...@.....H.AH.H.A..
@......A......HH@..............A@.A.....H..A....@.H........HA...@.....HHH..HH.A.@.....AH.A......@A...H....A..HAA@...H.......AH..
@A.A.H.....A.A..@.....H.........@......A........@....H.AH.A..AAH@......A...HH...@..H.H.....AH...@......A...A.A..@..A..A....H..H.
@......H.H..A...@..AHH.....AH.A.@..H...AHH.....A@.A.HH......H...@....A..........@.........A.H...@............H..@HHA...HA.......
@..H...H......HA@......H.....A..@.A.........H...@H.......A...HA.@..............A@..A...H....AHA.@.......H.......@.H.HHA....HA...
@H.A.AA....A...A@.......A..HA.H.@A..............@....H...AHA.H..@...HA.......A.H@.........H.....@.H......A...A..@......H.....A.H
@H.H........A...@...A...H..H....@..H.......A....@....H.........A@....H.H..AHHA..@...............@............H..@H.....A.A......
@.............AH@......AAH....H.@...............@..A.....HHA...H@A....A.A..H.H..@.....HH.H.H....@A.......H......@..H.A.H.A...A..
@.H.........HH.H@...A...H.......@.....A.........@H.........H...H@..A.AH.A..A....@A..H...A.......@...............@A......H.......
@H.....A...AH...@H....A...A.A...@.H..A...AA.....@.........H..A..@.......H..H..A.@.A.......A.....@A....A...AAA..H@.HH...A.HA..AH.
@.......HA.HA...@....H.....H....@.AH.....H......@...........A.H.@.......H...HH.A@.....HA......HH@....H.....A..A.@....A........A.
@....AAHA...H...@...........A...@......AH...AH..@....A....H.H...@HHH...H..H..H.A@.AA..A....AHH..@H..A..A....A...@......HA.......
@..............H@....HA.........@.........H....H@....AA..AA.....@..A.A.A..HH..AH@A....H.......A.@...H...........@........HA.....
@@@@@@@@@@@@@@@@@@@@@@@@@@@@@@@@@@@@@@@@@@@@@@@@@@@@@@@@@@@@@@@@@@@@@@@@@@@@@@@@@@@@@@@@@@@@@@@@@@@@@@@@@@@@@@@@@@@@@@@@@@@@@@@@
@A.AHA.....A....@A....AH........@.A.....A..H..HA@.....A........A@......H....AA..@..AA.....H.....@.H.HH....AH..A.@.......A.......
@....H..........@A......H.A.....@..........A....@.....A........A@.H..........HAH@.A........H....@A...HH........A@A.A....A......A
@.....H..H....H.@H..A..A.A...A.H@H......H..A....@....A.A.H..A...@.....H.........@.H.............@..........H....@......H........
@........AA.....@..A..A....AHHA.@...........H...@.......H...A...@........H.A....@......A....HH..@...AH.HHH..AH.H@AA.......A....A
@AA....H..A.....@...H..A.A......@.A..A.....H....@.......A..H....@....A.A........@AH.A...H.H.....@...A.........H.@.H....A.....A.H
@.......A..H..A.@.A....A....H...@..A....A...A..A@...H.........A.@........HH...AH@H.......A...A..@.H....H..H...A.@.........A....H
@H..H..H...H.A.H@H.......A...HHA@..H.......H.A..@..H..H.....A.A.@..HA..H.A....A.@.......A..A.H..@....H.....H....@..AH.........HA
@...........A.H.@.HHH...........@H.....AHHA...A.@AA.......H.....@H...A.....HA.HH@.HH....A..A....@........A......@A......H..A.A..
@..AA..A.HA.....@A.....AAA..H..H@A............A.@..........A..A.@.....H.H...A.H.@AA..........A..@.H.....A....A..@..........H.H..
@....H.....H..A.@.....A...AH..HA@...A.H....A....@.....HA....A...@......A...A..A.@.H.....HA.....A@....H.A........@..H.......A....
@.......A.......@....AH...H.....@.A..AA.......H.@........A.A.AHH@...A...H....H..@H..H....A.H..A.@...A..A..H.....@....A..A..A....
@..............H@..H....H.A....A@A.H.........A..@......A..H...H.@..........H....@.H.H.H.H.A.....@..A.........H..@..A.......H....
@...A..AH......A@..H.HH......H..@.....H........H@A.......A......@..........A....@........H......@...A.H..A.H.A..@....H........H.
@HH..........A..@.....A...AA..HA@......HH....A..@....H..H...AHH.@.H..A..H..A..AH@..........A....@.HH.........A..@..H.A.....A....
@.....A...AAA...@..........HH...@...........A...@......HA......H@..A.....A..H...@...............@....A..........@...H.....A.....
@@@@@@@@@@@@@@@@@@@@@@@@@@@@@@@@@@@@@@@@@@@@@@@@@@@@@@@@@@@@@@@@@@@@@@@@@@@@@@@@@@@@@@@@@@@@@@@@@@@@@@@@@@@@@@@@@@@@@@@@@@@@@@@@
@.H....AHH...A..@H....H.AHH.H...@..A.........HA.@..H.H....H..A..@A........HH....@..A......A..H.H@.HH...H........@........H.A....
@.A..........A..@A.AH........AAH@HA.............@...HH.H..H...AA@.......H....A..@...H........H..@.....A.H..AHH..@......A.A.....H
@...H..A..A....A@A......A.......@HA...........HA@HA............H@HA......A......@.....HA.....AA.@...............@..A.H.H..A.HHH.
@...............@.........HH....@.......HAA...H.@.A.A..A........@............H..@HA....A.AH.....@.A.............@......H..AH...H
@............AAA@..A....H.A.H...@AH.......AA....@...A....H...A..@H.............H@.....H.........@......A...AA...@..H..H.........
@.A.....A.......@...AA..AH......@.....A.........@..A....H.....HA@...H...A..H.HHH@....H.....H...A@...A...H..A....@..AH...H....H..
@.H.H.A...A..A.A@.A..........AHA@..........H....@...HA......H...@..HA..........A@.......HH......@H...A........A.@H....HA..HH.A..
@....HH....A....@....HA.A.H.A.AA@......HA...H.A.@...AA..HH.....A@...A...H....A.A@...H...........@....H..HAAH.A..@.H...HH..H....A
@.....HH........@A.......AA.....@........AA.....@....A..H...HA.H@.......H.......@..........A....@..............H@........HH.....
@......A.H...A..@A.......A.AH.H.@.........H...A.@..H...H.....H..@HA.......A.....@.H.........H.H.@...A.A.......H.@..A..A....H...A
@.H.H....A...H..@H..........AH..@...............@..A...A.......A@.A..........A..@.H....AA.......@........A......@..........HH...
@.HHH..H....A...@.....HH..A.....@...............@A....A...A.H..A@..........H....@.H..H...A....A.@..........A....@..A..HH.H......
@.......H..A...A@.............HH@.........H.A.H.@.......H.H.....@....H..HHA..H..@.AA............@H.H......H.....@H..AH....AAAA..
@.....H...A..AA.@.A.............@A...........AH.@....A...A..A...@.............HA@.H.A....A.A...A@...HHH.H.H..H..@H..AA.........A
@...A....A....A.@.....H.......AA@H..A....HA....H@....H...H......@...AA.....A....@...A......H....@.H......A.....A@.A....H..AH....
@@@@@@@@@@@@@@@@@@@@@@@@@@@@@@@@@@@@@@@@@@@@@@@@@@@@@@@@@@@@@@@@@@@@@@@@@@@@@@@@@@@@@@@@@@@@@@@@@@@@@@@@@@@@@@@@@@@@@@@@@@@@@@@@
@.H..A........A.@...H..AA.......@.............H.@............HH.@.......H.A.....@....H.....AA...@..A.H..........@........AH...A.
@...H....HA.....@....A...H...AH.@......HH...A...@.A..HHA........@.HA.H..A..A....@AAH...A...A....@...H...........@...............
@H........H.....@...H.H.H....H..@.A.......HH....@A...A.....HH.H.@A...H..........@A..H......A....@.HH....A.A..A..@.....A.........
@.H..H..A.......@............AHA@.........A.....@.........H.....@HA.............@.....A.........@..A...A........@...H.....HH....
@..AA...A.......@A..........H..H@HHHHA...H...A.A@..............A@A.....H...AA...@H....AA........@......AA.A.H...@...............
@A.A..HH.H....H.@.......A..A.H.H@.H.............@A..A.A.....H.A.@...AH.H...A.AA.@.H..H..........@......H.....A..@..A............
@.A.............@......H......H.@..AHH....H.....@H..HH.......H.A@.........A.....@.........A..H..@....A...H......@A...H.........H
@...............@AA.............@.......A.......@.H.....A.......@.....A....HH.H.@.A.....A..HH..H@...........HA..@....A....H.H...
@......A..A.A...@..A.....H......@........H......@...H....H.H.A..@...A.......A.A.@.......H.AH....@H......A.....A.@...H..A........
@H..H..AH.A..A..@....HH.A.A.....@..........A....@............H..@.....A.A.......@..H..........A.@..H...H......H.@...A..AHA.HH..H
@.H..H..A.......@.A........HHH..@.........H.....@....H..........@.......A....AA.@...H.H..H..A...@....H.....A.H..@.A......H..A...
@....A..A....H.H@......H...H..A.@.AH.A..H...A...@.A...AH.A...HH.@....H......H.H.@........H.....H@H.........AA...@........AH....A
@..HA..A.H......@...HH....AH...H@..AH...A.......@......H.H....H.@...A.A.........@AA.............@......A...H..A.@A...........AA.
@.....H........A@H.......HA.....@..H...........A@.H...H.......H.@...............@A.........A....@.....A..AHHH...@..........HH..A
@..........HA...@.H...HA...A...H@HA..A.AHA....HH@.H......H...H..@...A..A..A.HA..@..A............@.........A.....@AH...........A.
