10, 10
I...@@...G
..@@@@@...
...@@.....
.......@@@
.......@@@
......@@@@
........@@
..........
..........
..........