100,50
I...............@@@.................@@@.............................................................
................@@@.................@@@.............................................................
................@@@.................@@@.............................................................
................@@@.................@@@.....@@@.....................................................
............@@@.@@@.................@@@.....@@@............................................@@@......
............@@@.....................@@@.....@@@............................................@@@......
............@@@.....................@@@.....@@@............................................@@@......
............@@@.....................@@@.....@@@............................................@@@......
............................................@@@............................................@@@......
@@@@@@@@@@@@@@@@@@@@@@@@@@@@@@@@@@@@@@@@@@@@@@@@@@@@@@@@@@@@@@@@@@@@@@@@@@@@@@@@@@@@@@@@@@@@@@......
@@@@@@@@@@@@@@@@@@@@@@@@@@@@@@@@@@@@@@@@@@@@@@@@@@@@@@@@@@@@@@@@@@@@@@@@@@@@@@@@@@@@@@@@@@@@@@......
...........................................................................................@@@......
.....@@@@..................................................................................@@@......
.....@@@@@@@...............................................................................@@@......
........@@@@@@@.........................................................@@@@@@@@@@@@@@@@@@@@@@......
@@@@@@@@..@@@@@@........................................................@@@.........................
@@@@@@@@...@@@@@........................................................@@@.........................
...........@@@@@........................................................@@@.........................
.....@@@@@@@@@@@................@@@@@@@@@@@@@@@.........................@@@.......@@@@@@@@@@@@@@@@@@
.....@@@@@@@@@@@.............@@@@@@@@@@@@@@@@@@@@@......................@@@.......@@@@@@@@@@@@@@@@@@
...........@@@@@@...........@@@@@............@@@@@@@@...................@@@.......@@@@@@@@@@@@@@@@@@
...........@@@@@@..........@@@@@................@@@@@@@.................@@@.......@@@@@@@@@...@@@@@@
@@@@@@@@...@@@@@@.........@@@@.....................@@@@@@...............@@@.......@@@@@@........@@@@
@@@@@@@@...@@@@@@........@@@@..............@@@.......@@@@@@.......................@@@@@..@@@@....@@@
............@@@@@@.....@@@@@............@@@@@@@@@@@@...@@@@@......................@@@@@..@@@@@...@@@
............@@@@@@@...@@@@@............@@@@@@@@@@@@@@@...@@@@@....................@@@@@..@@@@@....@@
...@@@@@@@@@@@@@@@@..@@@@@.............@@@@@@@@@@@@@@@@....@@@@@..................@@@@@..@@@@@....@@
...@@@@@@@@@@@@@@@@@@@@@@.............@@@@@@...@@@@@@@@@....@@@@@@................@@@@@..@@@@.......
..............@@@@@@@@@...............@@@@@@....@@@@@@@@@.....@@@@@@..............@@@@@.@@@@@.......
................@@@@@@................@@@@@@.....@@@@@@@@.......@@@@@.............@@@@@.@@@@........
................@@@@@.................@@@@@@.......@@@@@@@.......@@@@@@...........@@@@..@@@@........
.................@@@..................@@@@@@.......@@@@@@@.........@@@@@@.........@@@@..@@@.........
......................................@@@@@@........@@@@@@...........@@@@@@.......@@@@.@@@..........
......................................@@@@@@........@@@@@@@............@@@@@@....@@@...@@@..........
......................................@@@@@@.........@@@@@@@.............@@@@@..@@@@...@@@..........
................@@@@@@@@@@@@@@........@@@@@@..@@@.....@@@@@@@.............@@@@@@@@@@...@@...........
..............@@@@@@@@@@@@@@@@@.......@@@@@@..@@@.....@@@@@@@@@............@@@@@@@@...@@@...........
............@@@@@@@@@@@@@@@@@@@@......@@@@@@..@@@......@@@@@@@@@..............@@@@@..@@@@...........
..........@@@@@@@@.........@@@@@@.....@@@@@@..@@@.......@@@@@@@@....................@@@@............
.......@@@@@@@@@...@@@@.....@@@@@.....@@@@@@..@@@.......@@@@@@@@@@................@@@@@.............
@@@@@@@@@@@@@....@@@@@@.....@@@@@.....@@@@@@..@@@........@@@@@@@@@.........@@@@@@@@@@...............
@@@@@@@@@@@@....@@@@@@@.....@@@@@....@@@@@@@..@@@.........@@@@@@@@@@@@@.@@@@@@@@@@@@................
@@@@@@@@@@.....@@@@@@@@@....@@@@@....@@@@@@@..@@@............@@@@@@@@@@@@@@@@@@@@@..................
.............@@@@@@@@@@@....@@@@@@@@@@@@@@@@..@@@..............@@@@@@@@@@@@@@@@@....................
.............@@@@@@@@@@@....@@.@@.@.@@@.@@.@..@@@.................@@@@@@@@@@@.......................
.............@@@@@@@@@@@....@@.@.....@.@.@.@..@@@.....................@@@...........................
.............@@@@@@@@@@@....@@.@@...@@...@.@..@@@.....................@@@...........................
..........@@@@@@@@@@@@@@@....@.@@@.@@@.@.@.@..@@@.....................@@@...........................
..........@@@@@@@@@@@@@@@@....@@@@@@@@@@@@@@..@@@.....................@@@...........................
G............@@@@@@@@@@@@@....................@@@...................................................
