100,50
I........H.....H@@@.............A...@@@.....A...AA..A......A..A..H...........H..A.H.A..............H
H..A....AA......@@@A...A.A..........@@@.H..A......A..............A..............H.....A...........AH
HHA..A..........@@@H........HH..HA.A@@@....AAA...A.....AA..A.............A.H....HA..........A..H....
............A.A.@@@.HAA.....H.......@@@....A@@@..A........H.A....H.A....A.............H....A......A.
......H.....@@@A@@@..........H......@@@H.H..@@@.HA.H.H......A.H....H.AH.......A.HHH.H....AA@@@...H.A
.A.......A..@@@H....A....A..A.......@@@.H.A.@@@.........AAA.......H.A...H.........HH..H....@@@....H.
....AH..A...@@@.AH......H.....HH....@@@HH...@@@.................A...H....A...H.....H.H.HHHA@@@H....A
.......H....@@@H.A.......HA......H..@@@...H.@@@.H.....A.H..........H...A...............H...@@@......
......H..................A.....H....A..AA.H.@@@.A.....HA.A...........H.A....A.H.........A..@@@HA..HH
@@@@@@@@@@@@@@@@@@@@@@@@@@@@@@@@@@@@@@@@@@@@@@@@@@@@@@@@@@@@@@@@@@@@@@@@@@@@@@@@@@@@@@@@@@@@@@......
@@@@@@@@@@@@@@@@@@@@@@@@@@@@@@@@@@@@@@@@@@@@@@@@@@@@@@@@@@@@@@@@@@@@@@@@@@@@@@@@@@@@@@@@@@@@@@......
A............H.H.......A.......HAA..........A....H....H...A.H........H....A...AA...........@@@......
HAH..@@@@............A...A........A......H...H.....H.....H..A..H...A...A..H......A.........@@@..H...
...H.@@@@@@@.A.A.....H.HAAA...........HA..HA...AA..A.....H.......A.A.A.......A.....H.......@@@....AH
......HH@@@@@@@..H......H..HA...H.AAA....................A..A..HA.......@@@@@@@@@@@@@@@@@@@@@@......
@@@@@@@@.H@@@@@@.H..A..........A..........AH.............H..H.H...H.....@@@..............A..........
@@@@@@@@..A@@@@@........H..H...A..A.........H.A.A....H.A..H.......A.H...@@@AH....H.H...........A...H
HH.....A...@@@@@.....A.......H.H....H.AA...A.AA.......H...A.AHH.H.A.A...@@@..A...H..A.A...A...A.....
.H...@@@@@@@@@@@.A.....HA.......@@@@@@@@@@@@@@@H.H.......A.........A....@@@......A@@@@@@@@@@@@@@@@@@
.A.A.@@@@@@@@@@@.......A.....@@@@@@@@@@@@@@@@@@@@@.....H..........H.H...@@@..H.A.H@@@@@@@@@@@@@@@@@@
H.......H.H@@@@@@.....A.AH..@@@@@.A.......A..@@@@@@@@....H.H..A.......H.@@@...H...@@@@@@@@@@@@@@@@@@
...........@@@@@@.......H.H@@@@@..............AA@@@@@@@H..........H....A@@@....H..@@@@@@@@@.HA@@@@@@
@@@@@@@@...@@@@@@......A..@@@@....H..AH....AA..A...@@@@@@.......A....AHH@@@A...HHH@@@@@@......A.@@@@
@@@@@@@@.A.@@@@@@...H.H.H@@@@HH.H......H...@@@.......@@@@@@....A.....H...H....H...@@@@@..@@@@..A.@@@
H....H...A.H@@@@@@.H...@@@@@.H...H.....H@@@@@@@@@@@@.HA@@@@@.....A......A.A.......@@@@@..@@@@@..H@@@
A.....H.H.A.@@@@@@@.A.@@@@@.......H..A.@@@@@@@@@@@@@@@.H.@@@@@..............A.H...@@@@@..@@@@@A...@@
.H.@@@@@@@@@@@@@@@@..@@@@@..A........H.@@@@@@@@@@@@@@@@H..H@@@@@.AHH..........A...@@@@@.H@@@@@....@@
...@@@@@@@@@@@@@@@@@@@@@@.A...AAAA...H@@@@@@..A@@@@@@@@@.AHH@@@@@@A....A..AAAH..H.@@@@@AH@@@@A......
..A...........@@@@@@@@@.......H.....A.@@@@@@....@@@@@@@@@..H..@@@@@@.H........A..A@@@@@A@@@@@.......
.A..HHH.HH......@@@@@@A.........HA....@@@@@@.AA..@@@@@@@@...AA..@@@@@A....AAH.....@@@@@.@@@@.AA.....
......H......H..@@@@@..A..A...........@@@@@@.......@@@@@@@.......@@@@@@....H....A.@@@@..@@@@........
...H....A...H..H.@@@...AA.............@@@@@@.A.....@@@@@@@.........@@@@@@.........@@@@H.@@@.H...H...
........H.......H.......A.....H....H..@@@@@@A.H.....@@@@@@....A...H..@@@@@@.....A.@@@@.@@@...H..HH..
.H....A........AH.......H.A...........@@@@@@A..AH.A.@@@@@@@..H.......AH@@@@@@....@@@H..@@@....H.....
.....A.............A....AH............@@@@@@.....H...@@@@@@@....HA..A....@@@@@..@@@@H..@@@..........
....AH.A....AAA.@@@@@@@@@@@@@@.......A@@@@@@..@@@.A.H.@@@@@@@.AH..A.......@@@@@@@@@@...@@.....H...H.
......H.......@@@@@@@@@@@@@@@@@.......@@@@@@H.@@@...H.@@@@@@@@@AH..A..H....@@@@@@@@...@@@........H.H
H.....A.....@@@@@@@@@@@@@@@@@@@@......@@@@@@..@@@.....H@@@@@@@@@.....A.......A@@@@@..@@@@..H.H.....H
A........H@@@@@@@@...H.....@@@@@@.....@@@@@@H.@@@.H.....@@@@@@@@....A...H..........A@@@@.A..........
......H@@@@@@@@@.A.@@@@.AH.H@@@@@...A.@@@@@@..@@@......H@@@@@@@@@@.HH.A.A.........@@@@@HA.HA.......H
@@@@@@@@@@@@@....@@@@@@...A.@@@@@..HH.@@@@@@A.@@@A....H..@@@@@@@@@HH.......@@@@@@@@@@....H.A.H..H...
@@@@@@@@@@@@...A@@@@@@@.....@@@@@..HH@@@@@@@..@@@.......H.@@@@@@@@@@@@@.@@@@@@@@@@@@A.....H.H.......
@@@@@@@@@@.....@@@@@@@@@..A.@@@@@.H..@@@@@@@..@@@A..A..H.....@@@@@@@@@@@@@@@@@@@@@......H....AA...A.
........A....@@@@@@@@@@@....@@@@@@@@@@@@@@@@A.@@@.A.......A....@@@@@@@@@@@@@@@@@HH.......A..........
H....H.......@@@@@@@@@@@....@@.@@.@.@@@.@@H@..@@@....A..H..A.A....@@@@@@@@@@@.AH.....A.....H....A...
...A..AH..A..@@@@@@@@@@@....@@A@...H.@.@H@A@..@@@.H.....H.H.......H...@@@.A..A..H..HHH.....H.AAAA...
...A.........@@@@@@@@@@@.A..@@H@@A..@@HH.@.@..@@@..........H........H.@@@.A............A...H.A.H....
.A........@@@@@@@@@@@@@@@....@.@@@.@@@.@.@.@.H@@@A......H.A...H...A.H.@@@...A......A.....A......H..A
..A...A...@@@@@@@@@@@@@@@@A..A@@@@@@@@@@@@@@..@@@.A....H.............A@@@..HH....A.....A....A..H.H..
G..A...HA.A..@@@@@@@@@@@@@......H.....H.....HH@@@..AAH......H..........A........A..A........A....A.A
